0,0,1;10,0,1;20,10,1
0,0,1;20,0,1;30,10,1
0,0,1;30,0,1;50,10,1
0,0,1;20,20,1;30,10,1
0,0,1;20,10,1;50,10,1